
%
1111111111111111111111111111111111111111111111111111
1                        111111111111111111111111111
1                         11       11111      111111
1                                111         1111111
1                                              111 1
1                                           111  111
1                                            11   11
1                                                  1
1                                                  1
1  1111                                            1
1    111                           11              1
1   11   11                       111              1
11   1  111                         11     11111   1
11        1                        111   1111111   1
1  1         11                     1111111111     1
1     111                               1111       1
1      1                                           1
1                                                  1
1                                                  1
1                                                  1
1                                                  1
1                                                  1
1                                                  1
1      1                                           1
1      111                      1111111            1
1  111111                      111        111111   1
1111111111111       111              111111     1  1
1  11111111111     11 111        111               1
1        1111111 11111111                          1
1             111111                               1
1             1 1111                               1
1           111 11                                 1
1            11  1                                 1
1                11                                1
1                11                                1
1                                                  1
1111111111111111111111111111111111111111111111111111
%

%
11111111111111111111111111111111111111111111111111111111111111111111111111111111
1 1 1  1  1                                                                    1
1 1  1  1                                                                      1
1  1   1                                                                       1
1  1   11                                                                      1
1   1   1                                                                      1
111                        1  11                                               1
1                          111                                                 1
1                         11                                                   1
1                     11  111                                                  1
1                     111111111                                                1
1                      111111111                                               1
1                   11111111111111                                             1
1                      1111111                                                 1
1                     1111111111111                                            1
1                 11111111111111                                               1
1              11111      1111111                                              1
1                                                                             11
1                                                                       111   11
1                                                                 11111111   111
1                                                            1111111111       11
1                                                       111111111111       11111
1                                                     11111111111111        1111
1                                                  11  11111111111           111
1                                                 111  1111111111             11
1                                                1111  1111111                11
1                                            1111111   11111        111       11
1                                      111111111111111  1111       1   1      11
1                            1  111 1111111111111111111 1          11         11
1                                11  11111111111111111                       111
1                                 1111111111111111111                     111111
1                                     111111111111111             111111  111111
1                                     111111111111111            111111111111111
11                                     1111111111111             111111111111111
1                                       111111111111                111111111111
11                                        1111111111                111111111111
11                                       11111111111111              11111111111
11                                     111111111111111                 111111111
1                                       111111111111111                   111111
111                                     11111111111111111                    111
111111111                               111111111111111111111                111
1111111111                                1111111111111111111111111111       111
1111111111111                                11111111111111111111111111111111111
11111111111111111111111111111111111111111111111111111111111111111111111111111111
%

%
1111111111111111111111111111111111111111111111111111111111111111111111111111111111111111111111111111111111111111111111111111111
1  1111111                                    1111111111111111111111111111111111                                  1111111111111
11 11  111111                                     1   11111111111111111   1111                                    1111111111111
11        111111                                           1111111  1      111                                      11111111  1
11            111                                            1111           11                                          11    1
111           11111                                           11            1                                                 1
11             11111          11111                                        1                                                  1
11    1        111111         11111                                        1                                                  1
111  111          1111     11111111                                                                                     1111111
11111111           1111    111111                                                                                   11111111111
111111111                11111111                                                                          11111111111111111111
111111111                111111                                                                         11111111111111111111111
1111111111               11                                                                          11111111111111111111111111
111111111111              1                                                                      111111111111111111111111111111
111111111111111                                                                                  111111111111111111111111111111
111111111111111111            11                                                               11111111111111111111111     1111
11111111111111111111          1111111 11111                                                111111111111111         111      111
111111111   1111111111   111    11111111111111                                             111111111111111         111111    11
1111111          1      1111       1111111111111111111     11111111                     1111111111                  11111    11
1111111  111          111111       11111111111111111111    11111111111         11  111111111111111                           11
1111111  1111111  11111111111        111111111111111111    111111111111111     111111111111111111                         11111
1111111  111111111111111111111       111111111111111111          111111111     1111111111111111                           11111
111111  1111111111111111111111       1111111111111111               111111     111111111111111                        111111111
111111    11111111111111111111         111111111111111              1111         11111111111       11                 111111111
11111111  111111111111111111               11111111111                11111       1111111111    11111    111111111       111111
11111111  111111111111111111                  11111111                  1111      11111111111   1111111111111111111111   111111
11111111  11111111111111111                   11111                     1111         11111111   1111111111111111          11111
11111111  11111111111111111                                              11             111111  11111111111                1111
111111111  111111111111111                                             1111                    1111111                      111
111111111  111111111111111                                               111             111111111111                       111
1111111111      11111111                                                11               11111111111                        111
111111111        1111                                                   11               11111111111                       1111
11111111                                                              111                111111111111                       111
111111111                                                           1111                 1111111111111                     1111
111111                                                    11   1111                        111111111111111                  111
111111                                               111  11                                1111111111111111                111
111111       11111      11                         1  11                                        11111111111                  11
1            11111111  11                          1                                              1111111111                 11
1          11111111111111                                                                              11111                 11
1          1111111111111                                                                               11111                  1
1          111111111111111                                                                           11111                    1
1           1111111111111111                                                                         111                      1
1             11111111111111                                                                         11                       1
1              1111111111                                                                            11                       1
1              11111    11111                         111                          1111           11                          1
1                111                                111                           11111            1111                       1
1                  111                              111                            111             1111                       1
1                  1111                              1                                              111                       1
1                    11                             11                                              11                        1
1                     1                             11                                            11  111                     1
1                                                                                                 11  11111                   1
1                                                            111                                         11                   1
1                                                  1     111111                                                               1
1                  1                               111111111                                                                  1
1                  11                            11      11                                          11                       1
1    11            1                             11                                                  11111                    1
1    111         111                           1                                                        11                    1
1   111111       11                        11111                                    1111                                      1
1   1111111    1111                      1111111                                    1111                                      1
1    111111111111                        1111                                         11                                      1
1       11111111                          111                                                                                 1
1          11111                                                                                                              1
1          11111                                                                                 111                          1
1            11                                                                                11111111                       1
1            11                                    1111     1                                       11111111111111111111      1
1                                                111111111111  11                   1111111111111111111111111111111111111111  1
1111111111111111111111111111111111111111111111111111111111111111111111111111111111111111111111111111111111111111111111111111111
%

%
1111111111111111111111111
1            111     11 1
1111111      111     11 1
1     1   1  1          1
1     11111  1    11 11 1
1            1 11 11 11 1
11111111111  1 11       1
1         1  1      11  1
1            11     11  1
1         1  11  11  11 1
11111111111  1   11  11 1
1         1  11         1
1            11    11   1
1         1  1     11   1
1 111111111  1 11       1
1 1       1  1 11    11 1
1 1          1       11 1
1 1       1  1   11     1
1 1       1  1   11     1
1 1       1  1 11       1
1 1          1 11  11   1
1 1       1  1     11   1
1 11111111111111111111  1
1                       1
1111111111111111111111111
%

%
00001000033333333
0      003      3
0      033      3
1               3
0               3
0      033      3
0      073      3
000  0007333  333
000  1777774  411
222  2227444  444
2      274      4
2      224      4
2               4
2               4
2      224      4
2      214      4
22222222144444444
%